 
               SO ./textures/b.png
  EA ./textures/porfile.png

                   C 100,100,100
      WE ./textures/emo.png
 F 160,160,160



   NO ./textures/carta.png

        1111111111111111111111111
        10000000001100000000000N1
        1011000001110000000000001
        1001000000000000000000001
111111111011000001110000000000001
100000000011000001110111111111111
11110111111111011100000010001
11110111111111011101010010001    
11000000110101011100000010001
100000     000001100000010001
10000000000000001101010010001
1100000111010101111101111000111
11110111 1110101 101111010001
11111111 1111111 111111111111